{
  "a": ["雅", "安", "艾"],
  "ba": ["柏", "白", "百"],
  "be": ["贝", "蓓", "北"],
  "ca": ["卡", "凯", "珂"],
  "cha": ["夏", "婵", "茶"], 
  "da": ["达", "黛", "妲"],
  "el": ["尔", "艾", "文"],
  "en": ["恩", "安", "文"],
  "er": ["尔", "洱", "珥"],
  "fa": ["法", "珐", "梵"],
  "ga": ["嘉", "佳", "迦"],
  "ha": ["海", "荷", "晗"],
  "ja": ["嘉", "婕", "洁"],
  "ka": ["卡", "凯", "珂"],
  "la": ["拉", "兰", "岚"],
  "li": ["丽", "莉", "立"],
  "ma": ["玛", "马", "麦"],
  "mi": ["米", "蜜", "宓"],
  "na": ["娜", "纳", "那"],
  "nel": ["妮", "内", "诺"],
  "ni": ["妮", "霓", "倪"],
  "no": ["诺", "娜", "暖"],
  "pa": ["帕", "琶", "葩"],
  "ra": ["拉", "冉", "然"],
  "ri": ["瑞", "日", "里"],
  "sa": ["萨", "莎", "飒"],
  "sha": ["莎", "沙", "纱"],
  "si": ["丝", "斯", "思"],
  "ta": ["塔", "妲", "它"],
  "ti": ["缇", "提", "蒂"],
  "tra": ["卓", "澈", "婵"],
  "ven": ["雯", "温", "文"],
  "ya": ["雅", "娅", "亚"],
  "za": ["扎", "萨", "飒"]
}
